7 7
#######
#..#.S#
#.....#
#...O.#
#.....#
##T.O.#
#######