18 12
##################
#...............O#
#..############..#
#..#O......O#....#
#..#..####..#....#
#..#...O....#..#.#
#..#..##.T..#..#.#
#..#...#......O#.#
#..###.#########.#
#.......O..O.....#
#S..............O#
##################