15 12
###############
#S...O..O#O...#
#..#.....#....#
#.O#..##.#.##.#
#O.#........O.#
#.###O......O.#
#.....O###....#
#O.....#O#.##.#
##..#.O.......#
#...#...O...O.#
#T.O#......O..#
###############