13 19
#############
#S.#.....O..#
#O.#..O.....#
#..#.######.#
#.O#.#...O..#
#....#.O...O#
######.######
#....O.#T.O.#
#..O...#.O..#
#.....O#....#
#.#########.#
#..#....#...#
#O....O.#.O.#
#######.#...#
#...O...#..O#
#......O#...#
#.O######O..#
#...........#
#############