13 14
#############
#S..#.......#
###.#.O.###.#
#...###.#.O.#
#..O#...###.#
#..###..O...#
#..O....#.###
#..#...O#...#
#..##..##.#.#
#......O..#O#
#######.....#
#...O...#O#O#
#....O....T.#
#############