12 16
############
#....O...O.#
#..O...O...#
#..O#O.O...#
#...#....O.#
#.O.#O.###.#
#...#......#
#...#..O...#
#O..#O...O.#
#...####...#
#..O..O#...#
#O.....#...#
######.#O..#
#...O..#O..#
#S....O#.T.#
############